NO ./textures/brick.xpm
SO ./textures/floor.xpm
EA ./textures/wood.xpm
WE ./textures/colorstone.xpm


C 135,206,235
F 0,255,0

11111111111111111111111111111
10000000001100000000000000001
10110000011100000000000010001
1001000000C000000000020010001
10110000011100000000000010001
10000000001100000111011110001
11110111111111011100000010001
11110111111111011100000010001
11000000110101011101010010001
10000000000000001100000010001
10000000000000001101010010001
11000000110101000000000000001
11110111110101000000000000001
10000000001100000100000010001
10000000000000001010000101001
10000000001000010001010201001
10000000001101000000N00000001
10000000000100000001010000001
11111111111111111111111111111
