NO ./textures/brick.xpm
SO ./textures/floor.xpm
EA ./textures/wood.xpm
WE ./textures/colorstone.xpm

F 184,113,39
C 51,198,227

11111111111111111111111111111
100000N0001100000000000000001
10110000011102000000000010201
1001000000C000000000000010001
10110000011100000000000010001
10000000001100000111011110001
11110111111111011100000010001
11110111111111011101010010001
11000000110101011100000010001
10002000000000001100000010001
10000000000000001101010010001
11020000110101000000000000001
11110111110101000000000000001
10000000001100000100200010001
10000000000000001010000101001
10200000001000010001010001001
10000000001101000200000200201
10000000000100000001010000001
11111111111111111111111111111
