NO ./textures/brick.xpm
SO ./textures/floor.xpm
EA ./textures/wood.xpm
WE ./textures/colorstone.xpm

F 184,113,39
C 51,198,227

11111111111111111111111111111
10000000001100000000000000001
10110000011100010000200010001
100100E000C000010000000010001
10110000011100000000000010001
10000000001100000111011110001
11110111111111011100000010001
11110111111111C11101010010001
11000000110101011100000010001
10011000000000001100000010001
10000000000000001102010020001
11000020110101000000000000001
11110111110101000000102000001
10000000011100000100000010001
1000000000C000002000000001001
10000000011100010001010001001
10000020001101000000020000001
10000000000100000001010000001
11111111111111111111111111111