NO ./textures/brick.xpm
SO ./textures/floor.xpm
EA ./textures/wood.xpm
WE ./textures/colorstone.xpm

F 184,113,39
C 51,198,227

11111
11001
10101
1N111
11011