NO ./textures/brick.xpm
SO ./textures/brick.xpm
WE ./textures/brick.xpm






EA                  ./textures/brick.xpm


F 250,250,0
C 0,0,250



        1111111111111111111111111
        1000000000110000000000001
        1011000001110000000000001
        1O11000000C0W000000000001
111111111011000001110000000000001111
100000000011111001110111111101100001
111101110111 10111000000100001111101
111101110111110111010100000011111101
110000000100000000000111111111111121
111111111111111111010001111111111101
                11C10111111000000101
111111111111111111011111111011111111
100000000000000000000000100000000001
120000000000000011010100000011111111
1100000111011101111101111000111
11110111 111 101 111111110001
11111111 111 111 111111111111
