NO ./textures/brick.xpm
SO ./textures/brick.xpm
WE ./texturesa/brick.xpm






EA                  ./textures/brick.xpm


F 220,100,0
C 225,30,0



        1111111111111111111111111
        1000000000110000000000001
        1011000001110000000000001
        1001000000000000000000001
111111111011000001110000000000001
100000000011000001110111111111111
11110111111111011100000010001
11110111111111011101010000001
1100000011000000000001111111
1111111111111111110100011111111111
                110101111110000001
1111111111111111110111111110111111
10000000000000000000000010001
10000000000000001101010000001
11000001110101011111011110N0111
11110111 1110101 111111110001
11111111 1111111 111111111111
