NO ./textures/brick.xpm
SO ./textures/brick.xpm
WE ./textures/brick.xpm






EA                  ./textures/brick.xpm


F 250,250,0
C 0,0,250



1111
1001
1N01
1111
1211
1111