NO ./textures/brick.xpm
SO ./textures/floor.xpm
EA ./textures/wood.xpm
WE ./textures/colorstone.xpm

C 135,206,235
F 0,255,0

111111111111
100000000001
100000000001
100000000001
100000000001
100000000001
10000S000001
100000110001
100000011001
100000000001
111111111111
