NO ./textures/brick.xpm
SO ./textures/brick.xpm
WE ./textures/brick.xpm






EA                  ./textures/brick.xpm


F 250,250,0
C 0,0,250



        1111111111111111111111111
        1000000000110000000000001
        1011000001110020000000001
        1001000000000000000020001
111111111011000001110000000000001111
100000000011111001110111111110100001
111101111111 10111000000100000111101
111101111111110111010100000010111101
110000001100000000000111111110111121
111111111111111111010001111110111101
                11010111111000000101
111111111111111111011111111011111101
100000000000000000000000100000000001
120000002000000011010100002011111111
110000011101010111110101110000000001
11110111 1110101 1111100C00000111101
111111111111111111111101111110111101
        1000000000110000000000000001
        1011000001110020000000001111
        1001000000C000000000N0001
111111111011000001110000000000001111
100000000011111001110111111011100001
111101111111 10011000000100211111101
111101111111110111010100000011111101
110000002000000000000111111111111121
111111111111111111010001111111111101
                11010111111000000101
111111111111111111000111111011111101
100000000000000000000000100000000001
120000000000000011010100000011111111
1100000111010101111101111000111
11110111 1110001 111111110001
11111111 1111111 111111111111

