NO ./textures/brick.xpm
SO ./textures/floor.xpm
EA ./textures/wood.xpm
WE ./textures/colorstone.xpm

F 200,20,37
C 200,23,250

11111111111111111111111111111
10000000001100000000000000001                111
10110000011102000000000010201                101
10010000000000000000000010001                111
10000000001100000100200010001                1
1000N000000000001010000101001                1
10000000001000010001010001001                1
1000000000110100020000020020111111111111111111
10000000000100000001010000001
11111111111111111111111111111