NO ./textures/brick.xpm
SO ./textures/floor.xpm
EA ./textures/wood.xpm
WE ./textures/colorstone.xpm

F 0   ,    0,    0
C 65, 46, 89

111111111111111111111111111111111111111111111111111111111111
1E0000000000000000000000010000000000000000000000000000000001
110111111111111101111111011111111111111011111111101100110101
100000000000010001000001000000000000001011110000101001000101
101111111111010110011101000111110001001000000110100001011001
100000000101010100100001000100000101001011111110111101000101
100110010000010000101111000111111101001010000000110101110101
100011111111001111110000000000000001000001111111100001000001
110000001000000010000111111111111111111111100000101111011101
111111010011111011110000001000000000000011111110101000001001
100110010010000010000001000001000100100000000000000001100101
100000010100010010110111111111111110111111111111101110001001
101111110100110010010100000100001010000000000000000001011101
100000010100000010110101010101101010101111111111111100100001
111111000001011000100001010001001010100000000000000010010111
100000011001000110101111111111011000100000000000000000000001
101111110011010100100010000000000110100000000000000000000001
101000010110010101011010000000000000000000000000000000000001
101011110100110101000010000000000000000000000000000000000001
100010000101000101111100000000000000000000000000000000000001
111010111000100100000100000000000000000000000000000000000001
100010111111111001110100000000000000000000000000000000000001
100110000000001000100100000000000000000000000000000000000001
100000111111101111111110000000000000000000000000000000000001
101000000000000000000100000000000000000000000000000000000001
101011111111111100011100111100001111111110000000000000000001
101000000000100001100000000000000000000001000000000001111111
111111111111111100100000000000000000000001111111111101000001
100000000000000000100000000000000000000000000100000000011001
101111111111111111111111111111111111111111111111111111111111
101
101
101
101
101
101
111