NO ./textures/brick.xpm
SO ./textures/floor.xpm
EA ./textures/wood.xpm
WE ./textures/colorstone.xpm

F 0   ,    0,    0
C 65, 46, 89

111111111111111111111111111111111111111111111111111111111111
1E0000000000000000000000010000000000000000000000000000000001
110111111111111101111111011111111111111011111111101100000001
100000000000010001000001000000000000001011110000101001000001
101111111111010110011101000111110001001000000110100001000001
100000000101010100100001000100000101001011111110111101000001
100110010000010000101111000111111101001010000000110101000001
100011111111001111110000000000000001000001111111100001000001
110000001000000000000111111111111111111111111111101111000001
111111010000000000000000000000000000000000000000000000000001
100110010000000000000000000000000000000000000000000000000001
100000010000000000000000000000000000000000000000000000000001
101111110000000000000000000000000000000000000000000000000001
100000010000000000000000000000000000000000000000000000000001
111111010000000000000000000000000000000000000000000000000001
100000010000000000000000000000000000000000000000000000000001
101111110000000000000000000000000000000000000000000000000001
100000000000000000000000000000000000000000000000000000000001
100000000000000000000000000000000000000000000000000000000001
100000000000000000000000000000000000000000000000000000000001
100000000000000000000000000000000000000000000000000000000001
100000000000000000000000000000000000000000000000000000000001
100000000000000000000000000000000000000000000000000000000001
100000000000000000000000000000000000000000000000000000000001
100000000000000000000000000000000000000000000000000000000001
100000000000000000000000000000000000000000000000000000000001
100000000000000000000000000000000000000000000000000001111111
100000000000000000000000000000000000000000000000000000000001
100000000000000000000000000000000000000000000000000001000001
111111111111111111111111111111111111111111111111111111111111