
NO ./textures/brick.xpm
      SO            ./textures/floor.xpm
EA ./textures/wood.xpm
WE ./textures/colorstone.xpm


    C 135,206,235
F 0,255,0




11111
11001
10101
1N011
11111
