NO ./textures/brick.xpm
SO ./textures/floor.xpm
EA ./textures/wood.xpm
WE ./textures/colorstone.xpm

F 0   ,    0,    0
C 65, 46, 89

      111111111111111111111111111111111111111111111111111111111111
      1E000000000000000000C0000100002C0000000000000000000000000001
      111111111111111101111111011111111111111011111111101100110101
      100002000000010001000001000000000000001011110000101001000101
      10111111111101011001110100011111020100100C000110100001011001111
      1000000001010101001000210001000001010010111111101111010001200011
   11110011001000001000010111100011111110100101000000011210111010000011
  1100000011111111001111110000000000C00001000001111111100001000001000011
111100110000001000000000C00111111111111111111111120000101111011101100001
110000111111010011111011110000001000000000000011111110101000001001100001
1001111001100100100000100000010000010001001000000C0000000001102101100001
101000100200010100010010110111111111111110111111111111101112001001100001
10101010111111C100110010010100000100001010000000000000000001011100000011
10101010000001010000001011010101010110101010111111111111110010000010011
1000101111110000010110001000010100010010101000000000000000100101111111
101010100000011001000110101111111111011000101101111111111011010001
1C1100111111110011010100100010020C00000110100000000000001001001101
12110010102C01011001C101011010011111110100000011111101100101100001
101001101011110100110101000010010000000101110000000100010100111101
1110100000100001010001011111001101110001C1000001110001010010000001
100010111010111000100100200101100101010101011000110011111001111111
101110100010111111111001110101001001010100001100010100000000000001
100C00100110000000001000100001001000010001000001110101111111111101
11111110000011111110111111111100111111111101011010010010000C200101
      101000000C00000000000100000000000000010000001110101111111101
      101011111111111100011101111101001111111110011111001000000001
      1010000200001000011000010201010000C0000001000000000001111111
      111111111111111100111110010101001111101001111111111101000001
      1000000000000000001000001000000000C00010000001200C0000011001
      101111111111111111111111111111111111111111111111111111111101
      1010000000000001                            1000000000000101
      1010000000000001                            1000000000000001
      1C10000000000001                            1000000000000101
      1010000000000001                            1000000000000101
      1010000000020001                            1000020000000101
      1000000000000001                            1000000000000101
      1111111111111111                            1111111111111111