NO ./textures/guard.xpm
SO ./textures/guard_attack4.xpm
EA ./textures/guard_attack1.xpm
WE ./textures/guard_attack2.xpm


C 135,206,235
F 0,255,0

11111111111111111111111111111
10000000001100000000000002001
10110020011100000020000010001
10010000000000000000000010001
10110000011100020000000010001
10000000001100000111011110001
11110111111111011100002010001
11110111111111011100000010001
11000000110101011101010010001
10000000200000001100000010021
12000000000000001101010010001
11000000110101000000000020001
11110111110101000000000000001
10000000001100000100000010001
10000000000000001010000101001
10000000001000010001010001001
10000020001121000000N00000001
10000200000100000001010000001
11111111111111111111111111111